0  0  18 0  0  0  0  0  0  0  0  0  0  0  0  0  
0  0  2  0  0  0  0  0  0  0  0  0  0  0  0  0  
0  0  6  4  4  4  4  4  4  4  4  134  0  0  0  0  
0  0  0  0  0  0  0  0  0  0  0  2  0  0  0  0  
0  0  0    0  0  138  8  8  137  0  0  6  4  134  0  0  
0  0  0    0  0  2  0  0  1  0  0  0  0  2  0  0  
0  0  0    0  0  2  0  0  1  0  0  0  0  2  0  0  
0  0  138  8  8  10  0  0  9  8  8  8  8  10 0  0  
0  0  2  0  0  0  0  0  0  0  0  0  0  0  0  0  
0  0  2  0  0  0  64 64 64 0  0  0  0  0  0  0  
0  0  6  4  134  0  64 64 64 64 0  0  0  0  0  0  
0  0  0  0  2  0  0  64 64 64 0  0  0  0  0  0  
0  0  0  0  2  0  0  0  0  0  0  0  0  0  0  0  
0  0  0  0  6  4  4  4  4  4  4  4  4  134  0  0  
0  0  0  0  0  0  0  0  0  0  0  0  0  2  0  0  
0  0  0  0  0  0  0  0  0  0  0  0  0  32 0  0  
